0000000000000222220000000000000000000
0000000000000215120000000000000000000
0000000000000211120000000000000000000
2222222000000221220000000000000000000
2444442000000021200000022222222220000
2444442000000021200000024411113320000
2444442000000021200000024411113320000
2111112000000021200000024411113320000
2111112000000021200000024411113320000
2111112000000021200000024411113320000
2111112000000021200222222221222220000
2111112222220021200233320021200000000
2221222311122221222211120021200000000
0021202311111111111111120021200000000
0021202311122221222211120021200000000
0021202221222221222221220021200000000
0021200021221111111221200021200000000
0021200021221111111221200021200002222
0021222221221111111221222221222222112
0021111111111111111111111111111111152
0021222221221111111221222221222222112
0021200021221111111221200021200002222
0021200021221111111221200021200000000
0021200221222221222221222021200000000
0021200211122221222211112021200000000
0021200211111111111111112021200000000
0021200211122221222233332021200000000
0021200233320021200222222221222000000
0021200222220021200000002511152000000
2221222222000021200000002511152000000
2111111112000021200000002111112000000
2111111112222221222222222111112000000
2111111111111111111111111111112000000
2333333332222222222222222111112000000
2444444442000000000000002333332000000
2222222222000000000000002333332000000
0000000000000000000000002222222000000
9
